17717111777
76717000031
10100061177
12106110041
70000060117
10101000057
11711177111